NO ./texture/wall/wall1.xpm
SO ./texture/wall/wall2.xpm
WE ./texture/wall/wall3.xpm
EA ./texture/wall/grass_block.xpm

F 220,100,0
C 225,30,0


11111111111111111111111111111
1S000000000000000000000000001
10000000000000000000000000001
10000000000000000000000000001
10000000000000000000000000001
10000000000000000000000000001
11111111111111111111111111111
