NO ./texture/wall/wall1.xpm
SO ./texture/wall/wall2.xpm
WE ./texture/wall/wall3.xpm
EA ./texture/wall/grass_block.xpm

F 220,100,0
C 225,30,0

        1111111111111111111111111
        10000000001100000000000S1
        1011000001110000000000001
        1001000000000000000000001
111111111011000001110000000000001
100000000011000001110111111111111
11110111111111011100000010001
11110111111111011101010010001
11000000110101011100000010001   111
10000000000000001100000010001   101
10000000000000001101010010001   111
1100000111010101111101111010111
11110111 1110101 101111010001
11111111 1111111 111111111111

111
101
101
111